Благоприятная возможность - Opportunity, possibility, chance
более того - Moreover, Furthermore
Быстро - Rapidly
вводить, представлять - Introduce, represent
вдруг, внезапно - suddenly, abruptly
вероятно - Likely, probably
Вести себя, работать - Behave, act, do, arrive
внепланетное продолжение - off-planet extension
Возбуждать - Stimulate
возвращаться - Return, come back
выгода, польза - benefit, profit, advantage
выдающийся, известный - Prominent, outstanding
Выполнение - Fulfilment
Выполнение, осуществление - Implementation, execution, effectuation
Действительно - Indeed
Для того чтобы - In order to
Должным образом, правильно - Properly, correctly, accuratly, rightly
Доставлять - Deliver, provide, supply, transmit
Достаточно - Enough
достаточно - Sufficiently, enough
достижение - achievement, attainment
Задача, полёт - Mission, goal, task, issue
Запускать - Launch, run, initiate
Инструмент - Tool
Исследование - Investigation, research, inquiry
Исследовать, изучать - Explore, research, examine
Кипеть - Boil, bubble
Международная космическая станция - International space station
Менять - Vary
можно принять за чудо - As to suggest magic
Мощность - Capacity
На пути - On route
набор лего - lego set
Нагрев - Heating
Нагревать, тепло - Heat
наконец - finally, at last
Неисправность, повреждение - Trouble, damage, failire, defect
Неподдающийся - Unamenable
ниже - Below, lower, under
Нуждаться - Lack, require
Обработка - Treatment
Обслуживать, содержать - Maintain, serve
Овладевать - Master, acquire
Один - Single
Оружие - Weapon
Оставаться, жить - Stay, remain, persist
осуществлять - Put into effect
открывать, обнаруживать - discover/find out
Отмечать - Note, mark, notice, point out
Охлаждать - Cool, chill
По крайней мере - At least, at least, at any rate
Полёт - Flight, escape, flying
Полный - Entire
Получать - To provide
Поочередно - Alternately, serially, succesvelly, it turn
поражает - is awesome
Почти, приблизительно - approximately
Предлагать - Suggest
Предприятие - Enterprise, business, establishment
Предсказывать - Predict, forecast, prognosticate
Представлять - Present, introduce
Представлять - Represent
Прибавлять, присоединять - Add, append, bring, increase
Привлекать, притягивать - Attract, involve, apeal
провод - Wire, conductor
продолжать - continue, go on, proceed
Продолжительность - Duration
Пропускать - Pass, skip
Пространство, космос - Space, area, expanse
Ранее, предварительно - Previously, earlier
Рекламировать - Advertise, publicize, announse
Связанный - Involved
Силовая установка, электростанция - Power plant
Следовательно - Hense
Следовать (за) - Follow, go, puraue
случайный, произвольный - Random, casual
Снабжать, обеспечивать - Supply, deliver, provide, serve
Со временем - In time
Соединять, подгонять - Fit, adjustable, worthy
Сооружение, оборудование - Facility, installation, construction, service
Сохраняться, длиться - Last, endure, persist
Способствовать, содействовать - Promote, contribute, facilitate, stimulate
Стоимость - Cost
Стремиться, иметь тенденцию - Tend, seek, aim
также - as well
Теплостойкий - Heat-resistant
терять - Lose, waste
удельное сопротивление - Resistivity
удовлетворительный - Satisfactory
Удовлетворять требованиям - To meet the demands, the requirements
Усиление - Amplification
Установка - Installation
Учреждать, организовывать - Establish, set up, prove, install
Широкий - Broad, wide, widespread
Электрический ток - Current, Electricity